5555411100
50000222x0
40000333x0
30000222x0
01111110x0
0000000000