3032332320
3030322220
3302332320
3032302320
3032332322
0022000000