0000000000
0100000010
0023113200
0023113200
0100000010