5500440055
0033003300
0000xx0000
0022222200
0110110110
0000000000